0000000000000000000000000000000000000000
0000000000000000000000000000000000000000
0000000000000000000000000000000000000000
0000000000000000000000000000000000000000
0000111100000000011110000000000000000000
0000111100000000011110000000000000000000
0000111100000000011110000000000000000000
0000111100000000011110000000011110000000
0000000000000000000000000000011110000000
0000000000000000000000000000011110000000
0000000000000000000000000000011110000000
0000000000000000000000000000000000000000
0000000011110000000000000000000000000000
0000000011110000000000000000000000000000
0000000011110000000000000000000000000000
0000000011110000000011110000000000000000
0000000000000000000011110000000000000000
0000000000000000000011110000000000000000
0000000000000000000011110000000000000000
0000000000000000000000000000000000000000
0000000000000000000000000000000000000000
0000000000000000000000000000000000000000
0000000000000000000000000000000000000000
